Adjust Everywhere	Adjust Everywhere	books/english/adjust-everywhere.pdf
Anger	Anger	books/english/anger.pdf
Avoid Clashes	Avoid Clashes	books/english/avoidclash.pdf
Brahmacharya: Celibacy (Attained with Understanding)	Brahmacharya: Celibacy (Attained with Understanding)	books/english/celibacy.pdf
Gnani Purush A.M. Patel	Gnani Purush A.M. Patel	books/english/dada.pdf
Death (Before, During and After..)	Death (Before, During and After..)	books/english/Death.pdf
The Essence of All Religion	The Essence of All Religion	books/english/essence-of-religion.pdf
The Fault is of the Sufferer	The Fault is of the Sufferer	books/english/fault-sufferer.pdf
The Flawless Vision	The Flawless Vision	books/english/flawless-vision.pdf
The Guru and The Disciple	The Guru and The Disciple	books/english/guru-shishya_english.pdf
Harmony in Marriage	Harmony in Marriage	books/english/harmony-in-marriage.pdf
The Scuence of Karma	The Scuence of Karma	books/english/karma.pdf
Life without Conflict	Life without Conflict	books/english/life-without-conflict.pdf
Noble use of Money	Noble use of Money	books/english/noble-use-of-money.pdf
Non - Violence (Ahimsa)	Non - Violence (Ahimsa)	books/english/non-violence.pdf
Money	Money	books/english/paisa-no-vyavahar.pdf
Pratikraman (The key that resolves all conflicts)	Pratikraman (The key that resolves all conflicts)	books/english/Pratikraman-English-full-Version.pdf
Pratikraman	Pratikraman	books/english/pratikraman.pdf
Pure Love	Pure Love	books/english/prem.pdf
Self Realization	Self Realization	books/english/Self-Realization.pdf
Right Understanding to Help Others	Right Understanding to Help Others	books/english/seva_english.pdf
Shree Simandhar Swami	Shree Simandhar Swami	books/english/Simandhar-swami.pdf
The Practice of Humanity	The Practice of Humanity	books/english/The-Practice-of-Humanity.pdf
Whatever has happens is Justice	Whatever has happens is Justice	books/english/whatever-happens-justice.pdf
Who am I?	Who am I?	books/english/who-am-i.pdf
Worries	Worries	books/english/worries.pdf
Aptavani - 01	Aptavani - 01	books/english/aptavani-01.pdf
Aptavani - 02	Aptavani - 02	books/english/aptavani-02.pdf
Aptavani - 04	Aptavani - 04	books/english/aptavani-04.pdf
Aptavani - 05	Aptavani - 05	books/english/aptavani-05.pdf
Aptavani - 06	Aptavani - 06	books/english/aptavani-06.pdf
Aptavani - 08	Aptavani - 08	books/english/aptavani-08.pdf
Aptavani - 09	Aptavani - 09	books/english/aptavani-09.pdf
