આપ્તસૂત્ર - સંપૂર્ણ	aaptsutra-full	books/gujarati/aaptsutra-full.pdf
આત્મ-સાક્ષાત્કાર પામવા માટેનું વિજ્ઞાન	Aatm-Sakshatkar	books/gujarati/Aatm-Sakshatkar.pdf
એડજસ્ટ એવરીવ્હેર	Adjust-Everywhere	books/gujarati/Adjust-Everywhere.pdf
અહિંસા	Ahinsa	books/gujarati/Ahinsa.pdf
અથડામણ ટાળો	Athadamal-Talo	books/gujarati/Athadamal-Talo.pdf
બન્યું તે જ ન્યાય	Banyu-te-j-nyay	books/gujarati/Banyu-te-j-nyay.pdf
ભાવના સુધારે ભવોભવ	Bhavna-sudhare-bhavobhav	books/gujarati/Bhavna-sudhare-bhavobhav.pdf
ભોગવે એની ભૂલ	Bhogve-eni-bhul	books/gujarati/Bhogve-eni-bhul.pdf
સમજથી પ્રાપ્ત બ્રહ્મચર્ય (સંક્ષિપ્ત)	Brahamacharya-sankshipt	books/gujarati/Brahamacharya-sankshipt.pdf
સમજથી પ્રાપ્ત બ્રહ્મચર્ય (પૂર્વાર્ધ)	Brahmacharya-purvadh	books/gujarati/Brahmacharya-purvadh.pdf
સમજથી પ્રાપ્ત બ્રહ્મચર્ય (ઉત્તરાર્ધ)	Brahmacharya-uttaradh	books/gujarati/Brahmacharya-uttaradh.pdf
ચમત્કાર	Chamatkar	books/gujarati/Chamatkar.pdf
ચિંતા	Chinta	books/gujarati/Chinta.pdf
દાન	Daan	books/gujarati/Daan.pdf
દાદા ભગવાન કોણ?	Dadabhagwan-kon	books/gujarati/Dadabhagwan-kon.pdf
જ્ઞાની પુરૂષ - ભાગ -૧	Gnani-Purush-Bhag-1	books/gujarati/Gnani-Purush-Bhag-1.pdf
જ્ઞાની પુરૂષ - ભાગ -2	Gnani-Purush-Bhag-2	books/gujarati/Gnani-Purush-Bhag-2.pdf
ગુરૂ-શિષ્ય	Gurushishya	books/gujarati/Gurushishya.pdf
હું કોણ છું?	Hu-kon-chhu	books/gujarati/Hu-kon-chhu.pdf
કર્મનું વિજ્ઞાન	Karm-nu-vignan	books/gujarati/Karm-nu-vignan.pdf
ક્લેશ વિનાનું જીવન	Klesh-Vinanu-Jivan	books/gujarati/Klesh-Vinanu-Jivan.pdf
ક્રોધ	krodh	books/gujarati/krodh.pdf
મા-બાપ છોકરાનો વ્યવહાર - ગ્રંથ	ma-bap-chhokarano-vyavhar-Granth	books/gujarati/ma-bap-chhokarano-vyavhar-Granth.pdf
મા-બાપ છોકરાનો વ્યવહાર	Maa-bap-chhokarano-vyavahar	books/gujarati/Maa-bap-chhokarano-vyavahar.pdf
માનવ ધર્મ	Manav-dharma	books/gujarati/Manav-dharma.pdf
મૃત્યુ સમયે, પહેલાં અને પછી	Mrutyu-tana-rahasyo	books/gujarati/Mrutyu-tana-rahasyo.pdf
નિજદોષ દર્શનથી નિર્દોષ!	Nijdosh-darsahn-thi-nirdosh	books/gujarati/Nijdosh-darsahn-thi-nirdosh.pdf
પાપ-પુણ્ય	Paap-punya	books/gujarati/Paap-punya.pdf
પૈસા નો વ્યવહાર (સંક્ષિપ્ત)	Paisa-no-vyavahar-sankshipt	books/gujarati/Paisa-no-vyavahar-sankshipt.pdf
પૈસા નો વ્યવહાર (સંપૂર્ણ)	paisa-no-vyavhar-granth	books/gujarati/paisa-no-vyavhar-granth.pdf
પતિ-પત્નિ નો દીવ્ય વ્યવહાર (સંક્ષિપ્ત)	Pati-patni-no-divya-vyavahar	books/gujarati/Pati-patni-no-divya-vyavahar.pdf
પતિ-પત્નિ નો દીવ્ય વ્યવહાર	Pati_Patni_No_Divya_Vyavahar_Granth	books/gujarati/Pati_Patni_No_Divya_Vyavahar_Granth.pdf
પ્રતિક્રમણ (સંક્ષિપ્ત)	Pratikraman	books/gujarati/Pratikraman.pdf
પ્રતિક્રમણ	Pratikraman_Granth	books/gujarati/Pratikraman_Granth.pdf
પ્રેમ	Prem	books/gujarati/Prem.pdf
સહજતા	sahajta	books/gujarati/sahajta.pdf
સત્ય અને અસત્યના રહસ્યો	Satysa-asatyana-rahasyo	books/gujarati/Satysa-asatyana-rahasyo.pdf
સેવા-પરોપકાર	Seva-paropkar	books/gujarati/Seva-paropkar.pdf
ત્રિમંત્ર	Trimantra	books/gujarati/Trimantra.pdf
વાણી વ્યવહારમાં	Vaani-vyavahar-ma	books/gujarati/Vaani-vyavahar-ma.pdf
વાણી નો સિદ્ધાંત	vani-no-siddhant-granth	books/gujarati/vani-no-siddhant-granth.pdf
વર્તમાન તીર્થંકર શ્રી સીમંધર સ્વામી	Vartman-tirthankar-shri-simandhar-swami	books/gujarati/Vartman-tirthankar-shri-simandhar-swami.pdf
સમ્યક સાધના	Samyak Sadhana	books/gujarati/Samyak Sadhana.pdf
સનાતન  સુખ	Sanatan Sukh	books/gujarati/Sanatan Sukh.pdf
આહાર વિજ્ઞાન	Aahar Vignan	books/gujarati/Aahar Vignan.pdf
આસ્વાદ - અવલોકન	Aaswad Avlokan	books/gujarati/Aaswad Avlokan.pdf
આત્મા' અનંત ગુણધામ	Aatma Anant Gun Dham	books/gujarati/Aatma Anant Gun Dham.pdf
અંતરાય કર્મ	Antray Karm	books/gujarati/Antray Karm.pdf
ભાવ પુરુષાર્થની પરાક્રમી સફર	Bhaav purusharth ni parakrami safar	books/gujarati/Bhaav purusharth ni parakrami safar.pdf
ભગવાન શું હશે?	Bhagwan Shu Hashe	books/gujarati/Bhagwan Shu Hashe.pdf
ભાવ-મન'થી 'મુક્ત'	Bhav Man Thi Mukt jeevan mukt	books/gujarati/Bhav Man Thi Mukt jeevan mukt.pdf
ચૈતન્ય સરિતા	Chaitanya Sarita	books/gujarati/Chaitanya Sarita.pdf
દાદા ભગવાનનું તત્વદર્શન	Dada Bhagwan nu tattvdarshan	books/gujarati/Dada Bhagwan nu tattvdarshan.pdf
દાદાની દ્રષ્ટિ	Dada Ni Drashti	books/gujarati/Dada Ni Drashti.pdf
જ્ઞાની - કૃષ્ણ ભગવાન - ગીતા	Gnani - Krashna Bhagwan - Gita	books/gujarati/Gnani - Krashna Bhagwan - Gita.pdf
જ્ઞાની અજવાળે મારગ મુક્તિનો	Gnani Ajvale Marag Muktino	books/gujarati/Gnani Ajvale Marag Muktino.pdf
ગ્રહ-આગ્રહ-નિરાગ્રહ	Grah Agrah Niragrah	books/gujarati/Grah Agrah Niragrah.pdf
ગુણદર્શન	Gun Darshan - KANUBHAI SUTRO	books/gujarati/Gun Darshan - KANUBHAI SUTRO.pdf
જીવન ધર્મ	Jeevan Dharm	books/gujarati/Jeevan Dharm.pdf
કૃપા	Krupa	books/gujarati/Krupa.pdf
મનથી મુક્તિ	Man Thi Mukti	books/gujarati/Man Thi Mukti.pdf
માનવ જીવન એ કુદરતી રચના	Manav Jivan ae Kudarati Rachana	books/gujarati/Manav Jivan ae Kudarati Rachana.pdf
મૌલિક વાતો "જ્ઞાની" ની	Maulik Vato Gnani Ni	books/gujarati/Maulik Vato Gnani Ni.pdf
મૂર્તિપૂજા	Murtipooja	books/gujarati/Murtipooja.pdf
ના હો લેશમાત્ર ક્લેશ કે કઢાપો	Na ho leshmatra klesh ke kadhapo	books/gujarati/Na ho leshmatra klesh ke kadhapo.pdf
નવી દ્રષ્ટિ	Navi Drashti	books/gujarati/Navi Drashti.pdf
નીમીત્ત - ઉપાદાન	Nimit Upadan	books/gujarati/Nimit Upadan.pdf
નિર્વિશેષ પદમાં સંસ્થિત અક્રમવિજ્ઞાની 'દાદાશ્રી'	Nirvishesh Pad Ma Sansthit Akramvignani Dadasrhi	books/gujarati/Nirvishesh Pad Ma Sansthit Akramvignani Dadasrhi.pdf
નીતિ-અનીતિ	Niti Aniti	books/gujarati/Niti Aniti.pdf
પરમ સુખનો વૈભવ	Param Sukh No Vaibhav	books/gujarati/Param Sukh No Vaibhav.pdf
પોઝીટીવ દ્રષ્ટિ	Positive Drashti	books/gujarati/Positive Drashti.pdf
પ્રગટ પ્રત્યક્ષ જ્ઞાનીપુરૂષની યથાર્થ ઓળખ	Pragat Pratyaksh Gnani Purush Ni Yatharth Odakh	books/gujarati/Pragat Pratyaksh Gnani Purush Ni Yatharth Odakh.pdf
પ્રજ્ઞાશક્તિ	Pragna Shakti	books/gujarati/Pragna Shakti.pdf
સત્ સાધન પંચામૃત (દીવો કરીએ)	Sat Sadhan Panchamrut [Divo kariae]	books/gujarati/Sat Sadhan Panchamrut [Divo kariae].pdf
શંકા	Shanka	books/gujarati/Shanka.pdf
શ્રી સીમંધર સ્વામી સ્વ-દર્શન	Sri Simandhar Swami Swa Darshan	books/gujarati/Sri Simandhar Swami Swa Darshan.pdf
સ્વ' - સ્વરૂપ અખંડ કીર્તન - ભક્તિ	Swa Swaroop Akhand Kirtan Bhakti	books/gujarati/Swa Swaroop Akhand Kirtan Bhakti.pdf
તેવો અને તેનો સ્વભાવ	Tevo Ane Teno Swabhav	books/gujarati/Tevo Ane Teno Swabhav.pdf
ઉકલે બ્રહ્માંડી રહસ્યો, 'કેવળ-જ્ઞાન' પ્રકાશે	Ukale Brahmandi Rahasyo, Keval-Gyan Prakashe	books/gujarati/Ukale Brahmandi Rahasyo, Keval-Gyan Prakashe.pdf
ઉપયોગ અને તેની ગોઠવણી	Upayog Ane Teni Gothavni	books/gujarati/Upayog Ane Teni Gothavni.pdf
પત્ર-નિશ્ચય - સ્વ. મ. ચંન્દ્રકાન્તભાઈ પટેલ ના પત્રો	Patra Nischay - Lt. M Chandrakantbhai Patel Letters	books/gujarati/Patra Nischay - Lt. M Chandrakantbhai Patel Letters.pdf
પુરુષાર્થ ધર્મ	Purusharth Dharm	books/gujarati/Purusharth Dharm.pdf
