एडजस्ट एवरीव्हेयर	adjust-everywhere	books/hindi/adjust-everywhere.pdf
अहिंसा	AHINSA-hindi	books/hindi/AHINSA-hindi.pdf
अंतःकरण का स्वरूप	antkaran_hindi	books/hindi/antkaran_hindi.pdf
आत्मबोध	atmabodh	books/hindi/atmabodh.pdf
आत्मसाक्षात्कार	Atmasakshatkar-hindi	books/hindi/Atmasakshatkar-hindi.pdf
भावना से सुधरे जन्मोंजन्म	bhavna_hindi	books/hindi/bhavna_hindi.pdf
भूगते उसी की भूल	bhugte-usiki-bhul	books/hindi/bhugte-usiki-bhul.pdf
समझ से प्राप्त ब्रह्मचर्य (संक्षिप्त)	brahmcharya_hindi	books/hindi/brahmcharya_hindi.pdf
समझ से प्राप्त ब्रह्मचर्य (पूर्वार्ध)	Brahmcharya-purvardh_hindi	books/hindi/Brahmcharya-purvardh_hindi.pdf
समझ से प्राप्त ब्रह्मचर्य (उत्तरार्ध)	Brahmcharya-uttaradh_hindi	books/hindi/Brahmcharya-uttaradh_hindi.pdf
चमत्कार	Chamatkar_hindi	books/hindi/Chamatkar_hindi.pdf
चिंता	chinta	books/hindi/chinta.pdf
दादा भगवान?	dada_kaun_hindi	books/hindi/dada_kaun_hindi.pdf
दान	dan	books/hindi/dan.pdf
ज्ञानीपुरुष की पहचान	gnani-purush	books/hindi/gnani-purush.pdf
गुरू शिष्य	guru_shishya	books/hindi/guru_shishya.pdf
ज्ञानीपुरुष दादा भगवान - १	Gyani-Purursh-Bhag-1_hindi	books/hindi/Gyani-Purursh-Bhag-1_hindi.pdf
ज्ञानीपुरुष दादा भगवान - २	Gyani-Purursh-Bhag-2_hindi	books/hindi/Gyani-Purursh-Bhag-2_hindi.pdf
हुआ सो न्याय	huaso-nyay	books/hindi/huaso-nyay.pdf
जगत कर्ता कौन?	jagat-karta_hindi	books/hindi/jagat-karta_hindi.pdf
कर्म का विज्ञान	Karma-ka-vignan_hindi	books/hindi/Karma-ka-vignan_hindi.pdf
कर्म का सिध्धांत	karma	books/hindi/karma.pdf
क्लेश रहित जीवन	Klesh-hindi	books/hindi/Klesh-hindi.pdf
क्रोध	Krodh	books/hindi/Krodh.pdf
मैं कौन हूं?	mai-kaun-hu	books/hindi/mai-kaun-hu.pdf
मानव धर्म	manav-dharma_hindi	books/hindi/manav-dharma_hindi.pdf
माता-पिता और बच्चों का व्यवहार	Mata-Pita-Bachcho-Ka-Vyavhar _hindi	books/hindi/Mata-Pita-Bachcho-Ka-Vyavhar _hindi.pdf
म्रुत्यु समय पहेले और पश्चात	mrutyu_samay_pahle_aur_pashchat	books/hindi/mrutyu_samay_pahle_aur_pashchat.pdf
निजदोष दर्शन से निर्दोष	NIJDOSH_Hindi	books/hindi/NIJDOSH_Hindi.pdf
पाप-पुण्य	paap-punya_hindi	books/hindi/paap-punya_hindi.pdf
पैसों का व्यवहार	paisa_hindi	books/hindi/paisa_hindi.pdf
पति-पत्नी का दिव्य व्यवहार	Pati-Patni-ka-Divya-Vyavhar_hindi	books/hindi/Pati-Patni-ka-Divya-Vyavhar_hindi.pdf
प्रतिक्रमण	pratikraman_hindi	books/hindi/pratikraman_hindi.pdf
प्रेम	Prem-Hindi	books/hindi/Prem-Hindi.pdf
सहजता	Sahajta_hindi	books/hindi/Sahajta_hindi.pdf
सर्व दुःखों से मुक्ति	sarva-dukh-se-mukti	books/hindi/sarva-dukh-se-mukti.pdf
सत्य-असत्य के रहस्य	Satya-Asatya-Hindi	books/hindi/Satya-Asatya-Hindi.pdf
सेवा-परोपकार	Seva-paropkar	books/hindi/Seva-paropkar.pdf
वर्तमान तीर्थंकर श्री सीमंधर स्वामी	simandhar-swami	books/hindi/simandhar-swami.pdf
टकराव टालिये	takrav-taliye	books/hindi/takrav-taliye.pdf
त्रिमंत्र	trimantra_hindi	books/hindi/trimantra_hindi.pdf
वाणी व्यवहार में	Vaani-Vyvahaar-Me_hindi	books/hindi/Vaani-Vyvahaar-Me_hindi.pdf
अंतराय कर्म	Antrai Karm (Hindi)	books/hindi/Antrai Karm (Hindi).pdf
आत्मा अनंत गुण निधि	Atma Anant Gun Nidhi	books/hindi/Atma Anant Gun Nidhi.pdf
भाव पुरूषार्थ की पराक्रमी सफर	Bhaav purusharth ki parakrami safar	books/hindi/Bhaav purusharth ki parakrami safar.pdf
नई द्रष्टि, नया विश्व	Nayi Drushti Naya Vishwa	books/hindi/Nayi Drushti Naya Vishwa.pdf
प्रेम की भाषा - अक्रम विज्ञान	Prem ki Bhasha- Hindi	books/hindi/Prem ki Bhasha- Hindi.pdf
सनातन सुख	Sanatan Sukh	books/hindi/Sanatan Sukh.pdf
आप्तवाणी श्रेणी-१	Aptavani - 1 (Hindi)	books/hindi/aptavani-1_hindi.pdf
आप्तवाणी श्रेणी-२	Aptavani - 2 (Hindi)	books/hindi/aptavani-2_hindi.pdf
आप्तवाणी श्रेणी-३	Aptavani - 3 (Hindi)	books/hindi/aptavani-3_hindi.pdf
आप्तवाणी श्रेणी-४	Aptavani - 4 (Hindi)	books/hindi/aptavani-4_hindi.pdf
आप्तवाणी श्रेणी-५	Aptavani - 5 (Hindi)	books/hindi/aptavani-5_hindi.pdf
आप्तवाणी श्रेणी-६	Aptavani - 6 (Hindi)	books/hindi/aptavani-6_hindi.pdf
आप्तवाणी श्रेणी-७	Aptavani - 7 (Hindi)	books/hindi/aptavani-7_hindi.pdf
आप्तवाणी श्रेणी-८	Aptavani - 8 (Hindi)	books/hindi/aptavani-8_hindi.pdf
आप्तवाणी श्रेणी-९	Aptavani - 9 (Hindi)	books/hindi/aptavani-9_hindi.pdf
