Adjust-Everywhere_Bengali	Adjust-Everywhere_Bengali	books/other/Adjust-Everywhere_Bengali.pdf
Athdaman-Talo_Bengali	Athdaman-Talo_Bengali	books/other/Athdaman-Talo_Bengali.pdf
Chinta-Bengali	Chinta-Bengali	books/other/Chinta-Bengali.pdf
Essence-Of-Religion-Bengali	Essence-Of-Religion-Bengali	books/other/Essence-Of-Religion-Bengali.pdf
Fault-Sufferer-Bengali	Fault-Sufferer-Bengali	books/other/Fault-Sufferer-Bengali.pdf
Krodh-Bengali	Krodh-Bengali	books/other/Krodh-Bengali.pdf
Right-Understanding-To-Help-Others-Bengali	Right-Understanding-To-Help-Others-Bengali	books/other/Right-Understanding-To-Help-Others-Bengali.pdf
Self-Realization_Bengali	Self-Realization_Bengali	books/other/Self-Realization_Bengali.pdf
The-Practice-of-Humanity-Bengali	The-Practice-of-Humanity-Bengali	books/other/The-Practice-of-Humanity-Bengali.pdf
whatever-happens-justice-Bengali	whatever-happens-justice-Bengali	books/other/whatever-happens-justice-Bengali.pdf
Who-Am-I-Bengali	Who-Am-I-Bengali	books/other/Who-Am-I-Bengali.pdf
Adjust-Every-Where-Telugu	Adjust-Every-Where-Telugu	books/other/Adjust-Every-Where-Telugu.pdf
Adjust-Everywhere-Kannada	Adjust-Everywhere-Kannada	books/other/Adjust-Everywhere-Kannada.pdf
Anthakaran-Kannad	Anthakaran-Kannad	books/other/Anthakaran-Kannad.pdf
Atmashakshatkar-Tamil	Atmashakshatkar-Tamil	books/other/Atmashakshatkar-Tamil.pdf
Atmashakshatkar_Kannad	Atmashakshatkar_Kannad	books/other/Atmashakshatkar_Kannad.pdf
Avoidclash-Kannad	Avoidclash-Kannad	books/other/Avoidclash-Kannad.pdf
avoidclash-telugu	avoidclash-telugu	books/other/avoidclash-telugu.pdf
Death-Kannada	Death-Kannada	books/other/Death-Kannada.pdf
Fault-is-of-the-Suffers-Telugu	Fault-is-of-the-Suffers-Telugu	books/other/Fault-is-of-the-Suffers-Telugu.pdf
whatever-happens-justice-malayalam	whatever-happens-justice-malayalam	books/other/whatever-happens-justice-malayalam.pdf
whatever-happens-justice-telugu	whatever-happens-justice-telugu	books/other/whatever-happens-justice-telugu.pdf
who-am-i-malayalam	who-am-i-malayalam	books/other/who-am-i-malayalam.pdf
Who-Am-I-Telugu	Who-Am-I-Telugu	books/other/Who-Am-I-Telugu.pdf
